1111111111111111111111
1010001011101110101111
1010101111111110000011
1000CCCCC00000000N0011
1011100000000010101111
1111110000010100000C11
10010000N00C0001100001
1001110001110110101011
1110000110000010111011
100000000000000000PCE1
1111111111111111111111