1111111111111111111111
1010001011101110101111
1010101111111111111011
1000000000000000001111
1011101111110010111011
1111110111010100010011
1001001111100011100101
1001111111110110101011
1110000110000010111011
100000001010000000PCE1
1111111111111111111111