1111111111111111111111111111111111
100000000C000000000000000000000001
1000000000000000000000000000000011
1000000000000000000000000000000001
1000000000000000000000000100000001
1000000000CCCCCC000000000C10000001
1000000000000000000000000100000001
1000C00000000000000000000000000001
101EP00000000000000000000000000001
1111111111111111111111111111111111