1111111111111111111111
1010001011101110101111
1010101111111110000011
1000CCCCC00000000N0011
1011100000000010101111
11111100000N0100000C11
10010000N00CN001100001
10011100011N0110101011
1110000110000010111011
100000000000000000P0E1
1111111111111111111111