1111111111111111111111
1010N01N11101110101111
1010101111111111111011
100CCCCC0000000N001111
1011100111110010111111
1111110111010100000C11
100100011110C011100001
1001110111110110100011
1110000110000010110011
10000000000N000000P0E1
1111111111111111111111