1111111111111111111111
10P0001011101110101111
1010101111111111111011
1000CCCCC0000000001111
1011100111110010111111
1111110111010100001C11
100100011110C011100001
1001110111110110100011
11100001C1000010111001
10000000000000000010E1
1111111111111111111111