1111111111111111111111
1010001011101110101111
1010101111111111111011
1000CCCCC0000000001111
1011100111110010111111
1111110111010100000C11
100100011110C011100001
1001110111110110101011
1110000110000010110001
100000000000000000P1E1
1111111111111111111111